eɪ -> EY
æ -> AE
ˈaɪ -> AY
aɪ -> AY
aʊ -> AW
ɑː -> AAH
ɑ -> AA
b -> B
ç -> CC
ð -> DH
dʒ -> JH
d -> D
a -> AH
ə -> AX
eː -> EEH
ɛː -> EHH
ɛ -> EH
ɚ -> AXR
ɝ -> ER
f -> F
ɡ -> G
h -> HH
iː -> IIH
i -> IY
ɪ -> IH
j -> Y
k -> K
l -> L
ɫ -> L
ɫ̩ -> EL
m -> M
m̩ -> EM
ɒn -> EN
n -> N
n̩ -> EN
ŋ -> NG
ŋ̍ -> ENG
œ -> OH
oʊ -> OW
øː -> OOH
oː -> OOH
ɔø -> OY
ˈɔ -> OO
ɔɪ -> OY
ɔ -> AO
p -> P
r -> RR
ɹ -> R
ɐ -> EX
ɜ -> EX
ɾ -> EX
ts -> TS
s -> S
tʃ -> CH
ʃ -> SH
t -> T
uː -> UUH
u -> UW
ʊ -> UU
v -> V
ʌ -> AH
w -> W
x -> X
yː -> YYH
ʏ -> YY
z -> Z
ʒ -> ZH
ʔ -> Q
θ -> TH
